agrave=a+grave@top
aacute=a+acute@top
acircumflex=a+circumflex@top
atilde=a+tilde@top
adieresis=a+uni0308@top
aring=a+uni030A@top

ccedilla=c+cedilla@bottom

egrave=e+grave@top
eacute=e+acute@top
ecircumflex=e+circumflex@top
edieresis=e+uni0308@top

igrave=dotlessi+grave@top
iacute=dotlessi+acute@top
icircumflex=dotlessi+circumflex@top
idieresis=dotlessi+dieresis@top

ntilde=n+tilde@top

ograve=o+grave@top
oacute=o+acute@top
ocircumflex=o+circumflex@top
otilde=o+tilde@top
odieresis=o+dieresis@top

ugrave=u+grave@top
uacute=u+acute@top
ucircumflex=u+circumflex@top
udieresis=u+dieresis@top

yacute=y+acute@top
ydieresis=y+dieresis@top

Agrave=A+grave.case@top
Aacute=A+acute.case@top
Acircumflex=A+circumflex.case@top
Atilde=A+tilde.case@top
Adieresis=A+dieresis.case@top
Aring=A+uni030A.case@top

Ccedilla=C+cedilla.case@bottom

Egrave=E+grave.case@top
Eacute=E+acute.case@top
Ecircumflex=E+circumflex.case@top
Edieresis=E+dieresis.case@top

Igrave=I+grave@top
Iacute=I+acute@top
Icircumflex=I+circumflex@top
Idieresis=I+dieresis@top

Ntilde=N+tilde.case@top

Ograve=O+grave.case@top
Oacute=O+acute.case@top
Ocircumflex=O+circumflex.case@top
Otilde=O+tilde.case@top
Odieresis=O+dieresis.case@top

Ugrave=U+grave.case@top
Uacute=U+acute.case@top
Ucircumflex=U+circumflex.case@top
Udieresis=U+dieresis.case@top

Yacute=Y+acute.case@top


