aacute=a+acutecomb@top
 aacute.italic=a.italic+acutecomb@top

aeacute=ae+acutecomb@top

cacute=c+acutecomb@top
 cacute.italic=c.italic+acutecomb@top

eacute=e+acutecomb@top
 eacute.italic=e.italic+acutecomb@top

iacute=dotlessi+acutecomb@top
 iacute.italic=dotlessi.italic+acutecomb@top
 iacute.mono=dotlessi.mono+acutecomb@top

lacute=l+acutecomb.case@top
 lacute.italic=l.italic+acutecomb.case@top
 lacute.sans=l.sans+acutecomb.case@top
 lacute.mono=l.mono+acutecomb.case@top

nacute=n+acutecomb@top
 nacute.italic=n.italic+acutecomb@top

oacute=o+acutecomb@top

oslashacute=oslash+acutecomb@top

racute=r+acutecomb@top
 racute.mono=r.mono+acutecomb@top
 racute.italic=r.italic+acutecomb@top

sacute=s+acutecomb@top
 sacute.italic=s.italic+acutecomb@top

uacute=u+acutecomb@top
 uacute.italic=u.italic+acutecomb@top

wacute=w+acutecomb@top
 wacute.italic=w.italic+acutecomb@top

yacute=y+acutecomb@top
 yacute.italic=y.italic+acutecomb@top

zacute=z+acutecomb@top
 zacute.italic=z.italic+acutecomb@top

Aacute=A+acutecomb.case@top

AEacute=AE+acutecomb.case@top

Cacute=C+acutecomb.case@top

Eacute=E+acutecomb.case@top

Iacute=I+acutecomb.case@top

Lacute=L+acutecomb.case@top

Nacute=N+acutecomb.case@top

Oacute=O+acutecomb.case@top

Oslashacute=Oslash+acutecomb.case@top

Racute=R+acutecomb.case@top

Sacute=S+acutecomb.case@top

Uacute=U+acutecomb.case@top

Wacute=W+acutecomb.case@top

Yacute=Y+acutecomb.case@top

Zacute=Z+acutecomb.case@top

abreve=a+brevecomb@top
 abreve.italic=a.italic+brevecomb@top

ebreve=e+brevecomb@top
 ebreve.italic=e.italic+brevecomb@top

gbreve=g+brevecomb@top
 gbreve.italic=g.italic+brevecomb@top

ibreve=dotlessi+brevecomb@top
 ibreve.italic=dotlessi.italic+brevecomb@top
 ibreve.mono=dotlessi.mono+brevecomb@top

obreve=o+brevecomb@top

ubreve=u+brevecomb@top
 ubreve.italic=u.italic+brevecomb@top

Abreve=A+brevecomb.case@top

Ebreve=E+brevecomb.case@top

Gbreve=G+brevecomb.case@top

Ibreve=I+brevecomb.case@top

Obreve=O+brevecomb.case@top

Ubreve=U+brevecomb.case@top

gcommaaccent=g+commaturnedabovecomb@top#turnedcommaaccentabove
 gcommaaccent.italic=g.italic+commaturnedabovecomb@top#turnedcommaaccentabove

kcommaaccent=k+commaaccentcomb@bottom
 kcommaaccent.italic=k.italic+commaaccentcomb@bottom

lcommaaccent=l+commaaccentcomb@bottom
 lcommaaccent.italic=l.italic+commaaccentcomb@bottom
 lcommaaccent.sans=l.sans+commaaccentcomb@bottom
 lcommaaccent.mono=l.mono+commaaccentcomb@bottom

ncommaaccent=n+commaaccentcomb@bottom
 ncommaaccent.italic=n.italic+commaaccentcomb@bottom

rcommaaccent=r+commaaccentcomb@bottom
 rcommaaccent.mono=r.mono+commaaccentcomb@bottom
 rcommaaccent.italic=r.italic+commaaccentcomb@bottom

scommaaccent=s+commaaccentcomb@bottom
 scommaaccent.italic=s.italic+commaaccentcomb@bottom

Gcommaaccent=G+commaaccentcomb.case@bottom

Kcommaaccent=K+commaaccentcomb.case@bottom

Lcommaaccent=L+commaaccentcomb.case@bottom

Ncommaaccent=N+commaaccentcomb.case@bottom

Rcommaaccent=R+commaaccentcomb.case@bottom

Scommaaccent=S+commaaccentcomb.case@bottom

Tcommaaccent=T+commaaccentcomb@bottom#Tcommabelow

tcommaaccent=t+commaaccentcomb.case@bottom#tcommabelow

agrave=a+gravecomb@top
 agrave.italic=a.italic+gravecomb@top

egrave=e+gravecomb@top
 egrave.italic=e.italic+gravecomb@top

igrave=dotlessi+gravecomb@top
 igrave.italic=dotlessi.italic+gravecomb@top
 igrave.mono=dotlessi.mono+gravecomb@top

ograve=o+gravecomb@top

ugrave=u+gravecomb@top
 ugrave.italic=u.italic+gravecomb@top

wgrave=w+gravecomb@top
 wgrave.italic=w.italic+gravecomb@top

ygrave=y+gravecomb@top
 ygrave.italic=y.italic+gravecomb@top

Agrave=A+gravecomb.case@top

Egrave=E+gravecomb.case@top

Igrave=I+gravecomb.case@top

Ograve=O+gravecomb.case@top

Ugrave=U+gravecomb.case@top

Wgrave=W+gravecomb.case@top

Ygrave=Y+gravecomb.case@top

ccaron=c+caroncomb@top
 ccaron.italic=c.italic+caroncomb@top

ecaron=e+caroncomb@top
 ecaron.italic=e.italic+caroncomb@top

gcaron=g+caroncomb@top
 gcaron.italic=g.italic+caroncomb@top

ncaron=n+caroncomb@top
 ncaron.italic=n.italic+caroncomb@top

rcaron=r+caroncomb@top
 rcaron.mono=r.mono+caroncomb@top
 rcaron.italic=r.italic+caroncomb@top

scaron=s+caroncomb@top
 scaron.italic=s.italic+caroncomb@top

zcaron=z+caroncomb@top
 zcaron.italic=z.italic+caroncomb@top

Ccaron=C+caroncomb.case@top

Dcaron=D+caroncomb.case@top

Ecaron=E+caroncomb.case@top

Gcaron=G+caroncomb.case@top

Ncaron=N+caroncomb.case@top

Rcaron=R+caroncomb.case@top

Scaron=S+caroncomb.case@top

Tcaron=T+caroncomb.case@top

Zcaron=Z+caroncomb.case@top

tcaron=t+commaaboverightcomb@caronslovak

Lcaron=L+commaaboverightcomb@caronslovak

napostrophe=n+commaaboverightcomb@caronslovak
 napostrophe.italic=n.italic+commaaboverightcomb@caronslovak

acircumflex=a+circumflexcomb@top
 acircumflex.italic=a.italic+circumflexcomb@top

ccircumflex=c+circumflexcomb@top
 ccircumflex.italic=c.italic+circumflexcomb@top

ecircumflex=e+circumflexcomb@top
 ecircumflex.italic=e.italic+circumflexcomb@top

gcircumflex=g+circumflexcomb@top
 gcircumflex.italic=g.italic+circumflexcomb@top

hcircumflex=h+circumflexcomb@top
 hcircumflex.italic=h.italic+circumflexcomb@top

icircumflex=dotlessi+circumflexcomb@top
 icircumflex.italic=dotlessi.italic+circumflexcomb@top
 icircumflex.mono=dotlessi.mono+circumflexcomb@top

jcircumflex=dotlessj+circumflexcomb@top
 jcircumflex.italic=dotlessj.italic+circumflexcomb@top

ocircumflex=o+circumflexcomb@top

scircumflex=s+circumflexcomb@top
 scircumflex.italic=s.italic+circumflexcomb@top

ucircumflex=u+circumflexcomb@top
 ucircumflex.italic=u.italic+circumflexcomb@top

wcircumflex=w+circumflexcomb@top
 wcircumflex.italic=w.italic+circumflexcomb@top

ycircumflex=y+circumflexcomb@top
 ycircumflex.italic=y.italic+circumflexcomb@top

Acircumflex=A+circumflexcomb.case@top

Ccircumflex=C+circumflexcomb.case@top

Ecircumflex=E+circumflexcomb.case@top

Gcircumflex=G+circumflexcomb.case@top

Hcircumflex=H+circumflexcomb.case@top

Icircumflex=I+circumflexcomb.case@top

Jcircumflex=J+circumflexcomb.case@top

Ocircumflex=O+circumflexcomb.case@top

Scircumflex=S+circumflexcomb.case@top

Ucircumflex=U+circumflexcomb.case@top

Wcircumflex=W+circumflexcomb.case@top

Ycircumflex=Y+circumflexcomb.case@top

ccedilla=c+cedillacomb@bottom
 ccedilla.italic=c.italic+cedillacomb@bottom

scedilla=s+cedillacomb@bottom
 scedilla.italic=s.italic+cedillacomb@bottom

tcedilla=t+cedillacomb@bottom#tcedilla

Ccedilla=C+cedillacomb.case@bottom

Scedilla=S+cedillacomb.case@bottom

Tcedilla=T+cedillacomb.case@bottom#Tcedilla

adieresis=a+dieresiscomb@top
 adieresis.italic=a.italic+dieresiscomb@top

edieresis=e+dieresiscomb@top
 edieresis.italic=e.italic+dieresiscomb@top

idieresis=dotlessi+dieresiscomb@top
 idieresis.italic=dotlessi.italic+dieresiscomb@top
 idieresis.mono=dotlessi.mono+dieresiscomb@top

odieresis=o+dieresiscomb@top

udieresis=u+dieresiscomb@top
 udieresis.italic=u.italic+dieresiscomb@top

wdieresis=w+dieresiscomb@top
 wdieresis.italic=w.italic+dieresiscomb@top

ydieresis=y+dieresiscomb@top
 ydieresis.italic=y.italic+dieresiscomb@top

Adieresis=A+dieresiscomb.case@top

Edieresis=E+dieresiscomb.case@top

Idieresis=I+dieresiscomb.case@top

Odieresis=O+dieresiscomb.case@top

Udieresis=U+dieresiscomb.case@top

Wdieresis=W+dieresiscomb.case@top

Ydieresis=Y+dieresiscomb.case@top

i=dotlessi+dotaccentcomb@top
 i.italic=dotlessi.italic+dotaccentcomb@top
 i.mono=dotlessi.mono+dotaccentcomb@top

j=dotlessj+dotaccentcomb@top
 j.italic=dotlessj.italic+dotaccentcomb@top

cdotaccent=c+dotaccentcomb@top
 cdotaccent.italic=c.italic+dotaccentcomb@top

edotaccent=e+dotaccentcomb@top
 edotaccent.italic=e.italic+dotaccentcomb@top

gdotaccent=g+dotaccentcomb@top
 gdotaccent.italic=g.italic+dotaccentcomb@top

zdotaccent=z+dotaccentcomb@top
 zdotaccent.italic=z.italic+dotaccentcomb@top

Cdotaccent=C+dotaccentcomb.case@top

Edotaccent=E+dotaccentcomb.case@top

Gdotaccent=G+dotaccentcomb.case@top

Idotaccent=I+dotaccentcomb.case@top

Zdotaccent=Z+dotaccentcomb.case@top

adotbelow=a+dotbelowcomb@bottom
 adotbelow.italic=a.italic+dotbelowcomb@bottom

edotbelow=e+dotbelowcomb@bottom
 edotbelow.italic=e.italic+dotbelowcomb@bottom

idotbelow=dotlessi+dotbelowcomb@bottom+dotaccentcomb@dotlessi:top
 idotbelow.italic=dotlessi.italic+dotbelowcomb@bottom+dotaccentcomb@dotlessi:top
 idotbelow.mono=dotlessi.mono+dotbelowcomb@bottom+dotaccentcomb@dotlessi:top

odotbelow=o+dotbelowcomb@bottom

udotbelow=u+dotbelowcomb@bottom
 udotbelow.italic=u.italic+dotbelowcomb@bottom

ydotbelow=y+dotbelowcomb@dot
 ydotbelow.italic=y.italic+dotbelowcomb@dot

Adotbelow=A+dotbelowcomb@bottom

Edotbelow=E+dotbelowcomb@bottom

Idotbelow=I+dotbelowcomb@bottom

Odotbelow=O+dotbelowcomb@bottom

Ydotbelow=Y+dotbelowcomb@dot

ohungarumlaut=o+hungarumlautcomb@top

uhungarumlaut=u+hungarumlautcomb@top
 uhungarumlaut.italic=u.italic+hungarumlautcomb@top

Ohungarumlaut=O+hungarumlautcomb.case@top

Uhungarumlaut=U+hungarumlautcomb.case@top

aogonek=a+ogonekcomb@ogonek
 aogonek.italic=a.italic+ogonekcomb@ogonek

iogonek=dotlessi+ogonekcomb@ogonek+dotaccentcomb@dotlessi:top
 iogonek.italic=dotlessi.italic+ogonekcomb@ogonek+dotaccentcomb@dotlessi:top
 iogonek.mono=dotlessi.mono+ogonekcomb@ogonek+dotaccentcomb@dotlessi:top

oogonek=o+ogonekcombo@ogonek

uogonek=u+ogonekcomb@ogonek
 uogonek.italic=u.italic+ogonekcomb@ogonek

Aogonek=A+ogonekcomb.case@ogonek

Eogonek=E+ogonekcomb.case@ogonek

Iogonek=I+ogonekcomb.case@ogonek

Oogonek=O+ogonekcombo.case@ogonek

Uogonek=U+ogonekcomb.case@ogonek

amacron=a+macroncomb@top
 amacron.italic=a.italic+macroncomb@top

emacron=e+macroncomb@top
 emacron.italic=e.italic+macroncomb@top

imacron=dotlessi+macroncomb@top
 imacron.italic=dotlessi.italic+macroncomb@top
 imacron.mono=dotlessi.mono+macroncomb@top

omacron=o+macroncomb@top

umacron=u+macroncomb@top
 umacron.italic=u.italic+macroncomb@top

ymacron=y+macroncomb@top
 ymacron.italic=y.italic+macroncomb@top

Amacron=A+macroncomb.case@top

Emacron=E+macroncomb.case@top

Imacron=I+macroncomb.case@top

Omacron=O+macroncomb.case@top

Umacron=U+macroncomb.case@top

Ymacron=Y+macroncomb.case@top

aring=a+ringcomb@top
 aring.italic=a.italic+ringcomb@top

uring=u+ringcomb@top
 uring.italic=u.italic+ringcomb@top

Aring=A+ringcomb.case@ring

Uring=U+ringcomb@top

aringacute=a+ringacute@top
 aringacute.italic=a.italic+ringacute@top

Aringacute=A+ringacute.case@ring

lslash=l+slashcomb@slash
 lslash.italic=l.italic+slashcomb@slash
 lslash.sans=l.sans+slashcomb@slash
 lslash.mono=l.mono+slashcomb@slash

Lslash=L+slashcomb.case@slash

atilde=a+tildecomb@top
 atilde.italic=a.italic+tildecomb@top

etilde=e+tildecomb@top
 etilde.italic=e.italic+tildecomb@top

itilde=dotlessi+tildecomb@top
 itilde.italic=dotlessi.italic+tildecomb@top
 itilde.mono=dotlessi.mono+tildecomb@top

ntilde=n+tildecomb@top
 ntilde.italic=n.italic+tildecomb@top

otilde=o+tildecomb@top

utilde=u+tildecomb@top
 utilde.italic=u.italic+tildecomb@top

ytilde=y+tildecomb@top
 ytilde.italic=y.italic+tildecomb@top

Atilde=A+tildecomb.case@top

Etilde=E+tildecomb.case@top

Itilde=I+tildecomb.case@top

Ntilde=N+tildecomb.case@top

Otilde=O+tildecomb.case@top

Utilde=U+tildecomb.case@top

Ytilde=Y+tildecomb.case@top

ohorn=o+horncomb@horn

uhorn=u+horncomb@horn
 uhorn.italic=u.italic+horncomb@horn

Ohorn=O+horncomb.case@horn

Uhorn=U+horncomb.case@horn

ohornacute=o+horncomb@horn+acutecombviet.case@o:top

uhornacute=u+horncomb@horn+acutecombviet.case@u:top
 uhornacute.italic=u.italic+horncomb@horn+acutecombviet.case@u:top

Ohornacute=O+horncomb.case@horn+acutecombviet.case@O:top

Uhornacute=U+horncomb.case@horn+acutecombviet.case@U:top

ohorngrave=o+horncomb@horn+gravecombviet.case@o:top

uhorngrave=u+horncomb@horn+gravecombviet.case@u:top
 uhorngrave.italic=u.italic+horncomb@horn+gravecombviet.case@u:top

Ohorngrave=O+horncomb.case@horn+gravecombviet.case@O:top

Uhorngrave=U+horncomb.case@horn+gravecombviet.case@U:top

ohornhook=o+horncomb@horn+hookcomb@o:hook

uhornhook=u+horncomb@horn+hookcomb@u:hook
 uhornhook.italic=u.italic+horncomb@horn+hookcomb@u:hook

Ohornhook=O+horncomb.case@horn+hookcomb.case@O:hook

Uhornhook=U+horncomb.case@horn+hookcomb.case@U:hook

ohorntilde=o+horncomb@horn+tildecombviet.case@o:tildeviet

uhorntilde=u+horncomb@horn+tildecombviet.case@u:tildeviet
 uhorntilde.italic=u.italic+horncomb@horn+tildecombviet.case@u:tildeviet

Ohorntilde=O+horncomb.case@horn+tildecombviet.case@O:tildeviet

Uhorntilde=U+horncomb.case@horn+tildecombviet.case@U:tildeviet

ohorndot=o+horncomb@horn+dotbelowcomb@o:bottom

uhorndot=u+horncomb@horn+dotbelowcomb@u:bottom
 uhorndot.italic=u.italic+horncomb@horn+dotbelowcomb@u:bottom

Ohorndot=O+horncomb.case@horn+dotbelowcomb.case@O:bottom

Uhorndot=U+horncomb.case@horn+dotbelowcomb.case@U:bottom

ahook=a+hookcomb@hook
 ahook.italic=a.italic+hookcomb@hook

ehook=e+hookcomb@hook
 ehook.italic=e.italic+hookcomb@hook

ihook=dotlessi+hookcomb@hook
 ihook.italic=dotlessi.italic+hookcomb@hook
 ihook.mono=dotlessi.mono+hookcomb@hook

ohook=o+hookcomb@hook

uhook=u+hookcomb@hook
 uhook.italic=u.italic+hookcomb@hook

yhook=y+hookcomb@hook
 yhook.italic=y.italic+hookcomb@hook

Ahook=A+hookcomb.case@hook

Ehook=E+hookcomb.case@hook

Ihook=I+hookcomb.case@hook

Ohook=O+hookcomb.case@hook

Uhook=U+hookcomb.case@hook

Yhook=Y+hookcomb.case@hook

acircumflexacute=a+circumflexcomb@top+acutecombviet.case@side
 acircumflexacute.italic=a.italic+circumflexcomb@top+acutecombviet.case@side

ecircumflexacute=e+circumflexcomb@top+acutecombviet.case@side
 ecircumflexacute.italic=e.italic+circumflexcomb@top+acutecombviet.case@side

ocircumflexacute=o+circumflexcomb@top+acutecombviet.case@side

Acircumflexacute=A+circumflexcomb.case@top+acutecombviet.case@side

Ecircumflexacute=E+circumflexcomb.case@top+acutecombviet.case@side

Ocircumflexacute=O+circumflexcomb.case@top+acutecombviet.case@side

acircumflexgrave=a+circumflexcomb@top+gravecombviet.case@side
 acircumflexgrave.italic=a.italic+circumflexcomb@top+gravecombviet.case@side

ecircumflexgrave=e+circumflexcomb@top+gravecombviet.case@side
 ecircumflexgrave.italic=e.italic+circumflexcomb@top+gravecombviet.case@side

ocircumflexgrave=o+circumflexcomb@top+gravecombviet.case@side

Acircumflexgrave=A+circumflexcomb.case@top+gravecombviet.case@side

Ecircumflexgrave=E+circumflexcomb.case@top+gravecombviet.case@side

Ocircumflexgrave=O+circumflexcomb.case@top+gravecombviet.case@side

acircumflexhook=a+circumflexcomb@top+hookcomb.case@side
 acircumflexhook.italic=a.italic+circumflexcomb@top+hookcomb.case@side

ecircumflexhook=e+circumflexcomb@top+hookcomb.case@side
 ecircumflexhook.italic=e.italic+circumflexcomb@top+hookcomb.case@side

ocircumflexhook=o+circumflexcomb@top+hookcomb.case@side

Acircumflexhook=A+circumflexcomb.case@top+hookcomb.case@side

Ecircumflexhook=E+circumflexcomb.case@top+hookcomb.case@side

Ocircumflexhook=O+circumflexcomb.case@top+hookcomb.case@side

acircumflextilde=a+circumflexcomb@top+tildecombviet.case@top
 acircumflextilde.italic=a.italic+circumflexcomb@top+tildecombviet.case@top

ecircumflextilde=e+circumflexcomb@top+tildecombviet.case@top
 ecircumflextilde.italic=e.italic+circumflexcomb@top+tildecombviet.case@top

ocircumflextilde=o+circumflexcomb@top+tildecombviet.case@top

Acircumflextilde=A+circumflexcomb.case@top+tildecombviet.case@top

Ecircumflextilde=E+circumflexcomb.case@top+tildecombviet.case@top

Ocircumflextilde=O+circumflexcomb.case@top+tildecombviet.case@top

acircumflexdot=a+circumflexcomb@top+dotbelowcomb@a:bottom
 acircumflexdot.italic=a.italic+circumflexcomb@top+dotbelowcomb@a:bottom

ecircumflexdot=e+circumflexcomb@top+dotbelowcomb@e:bottom
 ecircumflexdot.italic=e.italic+circumflexcomb@top+dotbelowcomb@e:bottom

ocircumflexdot=o+circumflexcomb@top+dotbelowcomb@o:bottom

Acircumflexdot=A+circumflexcomb.case@top+dotbelowcomb.case@A:bottom

Ecircumflexdot=E+circumflexcomb.case@top+dotbelowcomb.case@E:bottom

Ocircumflexdot=O+circumflexcomb.case@top+dotbelowcomb.case@O:bottom

abreveacute=a+brevecomb@top+acutecombviet.case@top
 abreveacute.italic=a.italic+brevecomb@top+acutecombviet.case@top

Abreveacute=A+brevecomb.case@top+acutecombviet.case@top

abrevegrave=a+brevecomb@top+gravecombviet.case@top
 abrevegrave.italic=a.italic+brevecomb@top+gravecombviet.case@top

Abrevegrave=A+brevecomb.case@top+gravecombviet.case@top

abrevehook=a+brevecomb@top+hookcomb.case@hook
 abrevehook.italic=a.italic+brevecomb@top+hookcomb.case@hook

Abrevehook=A+brevecomb.case@top+hookcomb.case@hook

abrevetilde=a+brevecomb@top+tildecombviet.case@top
 abrevetilde.italic=a.italic+brevecomb@top+tildecombviet.case@top

Abrevetilde=A+brevecomb.case@top+tildecombviet.case@top

abrevedot=a+brevecomb@top+dotbelowcomb@a:bottom
 abrevedot.italic=a.italic+brevecomb@top+dotbelowcomb@a:bottom

Abrevedot=A+brevecomb.case@top+dotbelowcomb.case@A:bottom

